"id_games","word_length","amount_vowels","amount_consonants","time_find_word","status"
1,11,4,7,0.9305079999976442,1
2,10,5,5,1.0222429999994347,1
3,13,5,8,0.8786399999989953,1
4,8,3,5,1.0662430000011227,1
5,12,5,7,1.0433109999976296,1
6,11,4,7,1.5112030000018422,1
7,5,2,3,2.0724169999994047,1
8,8,4,4,1.6866689999988012,1
9,8,4,4,1.7362489999977697,1
10,12,6,6,0.9411209999998391,1
11,5,2,3,1.5472409999965748,1
12,11,5,6,1.0533030000005965,1
13,7,2,5,0.8820130000021891,1
14,7,3,4,1.8930359999976645,1
15,7,4,3,2.046183000002202,1
16,7,4,3,1.0311779999974533,1
17,15,6,9,0.9216849999975238,1
18,9,4,5,1.717689999997674,1
19,5,2,3,1.8117509999974573,1
20,11,5,6,0.9323130000011588,1
21,13,6,7,1.3344820000056643,1
22,7,3,4,1.614411000002292,1
23,9,3,6,1.374536999996053,1
24,15,7,8,0.8401420000009239,1
25,10,4,6,1.4009649999934481,1
26,10,5,5,0.9362209999962943,1
27,12,7,5,0.8050870000006398,1
28,9,4,5,1.1164389999903506,1
29,7,3,4,1.462243000001763,1
30,8,4,4,1.4176790000055917,1
31,9,4,5,1.4380509999900823,1
32,12,5,7,0.932911999989301,1
33,7,2,5,0.8246090000029653,1
34,11,5,6,0.9967539999925066,1
35,8,4,4,1.0671539999893866,1
36,9,4,5,1.4507680000097025,1
37,13,7,6,0.8443089999927906,1
38,8,4,4,2.01419299999543,1
39,6,3,3,1.8512009999976726,1
40,4,2,2,1.7054300000017975,1
41,13,6,7,0.846493000004557,1
42,7,2,5,0.9713879999908386,1
43,6,3,3,1.8063450000045123,1
44,9,4,5,1.4340070000034757,1
45,6,3,3,1.4260470000008354,1
46,6,3,3,1.4009300000034273,1
47,6,2,4,1.2912070000020321,1
48,8,4,4,1.3905510000040522,1
49,9,5,4,1.2546200000069803,1
50,9,5,4,0.9241719999990892,1
51,10,5,5,0.9017490000114776,1
52,10,5,5,1.3247739999933401,1
53,7,3,4,1.5058129999961238,1
54,6,3,3,1.4152309999917634,1
55,10,5,5,0.9320429999934277,1
56,7,3,4,1.9167940000043018,1
57,11,5,6,1.3953650000039488,1
58,9,4,5,1.449269999997341,1
59,7,3,4,1.5458720000024186,1
60,8,4,4,1.0305550000048243,1
61,7,3,4,1.0873819999978878,1
62,9,5,4,0.8356040000071516,1
63,14,7,7,0.8601290000078734,1
64,4,2,2,1.7363590000022668,1
65,5,3,2,1.308050000006915,1
66,6,4,2,0.892664999992121,1
67,11,5,6,0.9330550000013318,1
68,14,6,8,0.8207750000001397,1
69,9,5,4,0.8703210000094259,1
70,8,3,5,1.3036250000004657,1
71,8,3,5,0.9568319999962114,1
72,7,3,4,1.9208599999983562,1
73,10,4,6,1.3747679999942193,1
74,11,4,7,0.8814660000061849,1
75,14,7,7,0.8213140000007115,1
76,10,4,6,0.9222050000098534,1
77,10,4,6,1.2667829999991227,1
78,8,4,4,0.9978780000092229,1
79,7,3,4,1.802561999997124,1
80,10,5,5,0.9057560000073863,1
81,10,4,6,1.0236589999985881,1
82,7,4,3,1.2498930000001565,1
83,16,6,10,0.8112870000040857,1
84,7,4,3,1.261582000006456,1
85,8,3,5,1.3321869999927003,1
86,6,2,4,1.252876999991713,1
87,8,3,5,1.518748999995296,1
88,8,5,3,0.8512190000037663,1
89,7,3,4,1.4611359999980778,1
90,5,2,3,1.756057000005967,1
91,7,3,4,1.421610999997938,1
92,11,5,6,0.9416979999950854,1
93,8,3,5,0.962827000010293,1
94,13,6,7,0.8366450000030454,1
95,5,2,3,1.7281899999943562,1
96,11,5,6,0.9206249999988358,1
97,5,2,3,1.7306269999971846,1
98,9,4,5,1.060684999989462,1
99,11,6,5,1.2403619999968214,1
100,4,2,2,1.6168990000005579,1
101,8,4,4,1.6825650000100723,1
102,11,5,6,1.2879509999911534,1
103,5,2,3,2.1110350000089966,1
104,6,3,3,1.3936300000059418,1
105,9,4,5,1.0298550000006799,1
106,6,3,3,1.3260569999984,1
107,6,2,4,1.2990200000058394,1
108,6,3,3,0.9643999999971129,1
109,7,3,4,1.4416580000106478,1
110,11,5,6,0.9078370000061113,1
111,6,3,3,1.6918040000018664,1
112,5,2,3,1.67081500000495,1
113,9,5,4,1.2719750000105705,1
114,5,2,3,1.6723729999939678,1
115,11,5,6,1.2804550000000745,1
116,13,6,7,1.2541390000114916,1
117,15,7,8,0.8111770000105025,1
118,5,2,3,2.128746999995201,1
119,6,3,3,1.336715000012191,1
120,9,5,4,1.2130429999961052,1
121,7,3,4,1.4613989999925252,1
122,10,5,5,0.8990690000064205,1
123,7,3,4,1.4347820000111824,1
124,8,4,4,0.9690380000101868,1
125,12,5,7,0.8968840000015916,1
126,7,3,4,1.4831080000003567,1
127,10,5,5,1.4181940000125905,1
128,12,5,7,0.8847420000092825,1
129,10,4,6,1.131907000002684,1
130,11,6,5,1.2232220000005327,1
131,15,7,8,0.9540829999896232,1
132,8,3,5,1.355225999999675,1
133,10,5,5,0.933947999990778,1
134,7,3,4,1.474753000002238,1
135,5,2,3,1.1635439999954542,1
136,5,2,3,2.1435869999986608,1
137,6,4,2,0.8258289999939734,1
138,7,3,4,1.4349610000062967,1
139,6,3,3,2.1114660000021104,1
140,8,3,5,1.3653070000000298,1
141,9,5,4,0.868720000013127,1
142,9,4,5,1.460423999989871,1
143,5,1,4,1.5471679999900516,1
144,5,2,3,2.2206479999877047,1
145,14,7,7,0.9189670000050683,1
146,14,6,8,1.0992649999971036,1
147,10,4,6,1.9238269999914337,1
148,14,7,7,0.9013569999951869,1
149,8,5,3,0.8354589999944437,1
150,8,5,3,0.8215189999900758,1
151,6,3,3,1.7593180000112625,1
152,6,1,5,0.8060100000002421,1
153,5,3,2,1.9788859999971464,0
154,11,5,6,0.9561770000000251,1
155,10,4,6,0.9629350000031991,1
156,10,5,5,1.2805630000075325,1
157,8,4,4,1.6334979999955976,1
158,9,4,5,1.0125430000043707,1
159,5,2,3,1.8445500000088941,1
160,14,7,7,0.8000599999941187,1
161,7,3,4,1.4157419999974081,1
162,4,2,2,2.002282000001287,1
163,9,3,6,0.8487699999968754,1
164,12,5,7,1.2783809999964433,1
165,4,2,2,1.2327910000021802,1
166,8,3,5,0.9369909999950323,1
167,8,4,4,1.413553000005777,1
168,8,3,5,0.9085139999951934,1
169,7,3,4,1.8413109999964945,1
170,9,4,5,1.022410999998101,1
171,12,5,7,0.903638999996474,1
172,9,3,6,0.8747589999984484,1
173,9,5,4,0.8616970000002766,1
174,9,5,4,0.8367230000003474,1
175,11,4,7,0.8447259999957168,1
176,10,5,5,1.2854179999994813,1
177,9,4,5,1.0517720000061672,1
178,5,3,2,1.228398000006564,1
179,8,4,4,0.9953189999941969,1
180,6,2,4,1.2739000000001397,1
181,4,2,2,2.1835359999968205,1
182,7,2,5,1.2619509999931324,1
183,5,2,3,2.1423030000005383,1
184,8,3,5,1.5421340000029886,1
185,6,2,4,1.096032000001287,1
186,9,4,5,1.4313929999916581,1
187,11,6,5,0.8145019999938086,1
188,9,4,5,1.4115429999947082,1
189,8,3,5,0.9908290000021225,1
190,6,3,3,1.778178000007756,1
191,11,5,6,0.9110979999968549,1
192,11,6,5,0.8653079999930924,1
193,8,3,5,0.9514369999960763,1
194,8,3,5,0.9808210000046529,1
195,7,3,4,1.1646999999938998,1
196,9,3,6,0.8427899999951478,1
197,6,3,3,1.0127150000043912,1
198,14,6,8,0.824001999993925,1
199,11,5,6,0.9426139999995939,1
200,8,4,4,1.4146069999987958,1
201,7,2,5,1.2069340000016382,1
202,5,2,3,1.7564299999939976,1
203,6,3,3,0.9928630000067642,1
204,9,4,5,1.8010110000032,1
205,7,3,4,1.490470999997342,1
206,8,4,4,1.3890859999955865,1
207,9,4,5,1.5296959999977844,1
208,11,5,6,0.9530739999900106,1
209,11,5,6,0.9295719999936409,1
210,9,4,5,1.0101509999949485,1
211,9,4,5,1.4188540000031935,1
212,6,2,4,0.9256370000075549,1
213,7,3,4,1.5045700000046054,1
214,8,4,4,1.4200759999948787,1
215,11,5,6,1.360279000000446,1
216,5,2,3,1.7022560000041267,1
217,11,5,6,0.9222000000008848,1
218,10,5,5,1.2972569999983534,1
219,8,4,4,1.3626799999910872,1
220,7,4,3,1.2513940000062576,1
221,6,2,4,0.9076349999959348,1
222,6,3,3,1.7825960000045598,1
223,7,2,5,1.2632489999959944,1
224,9,5,4,0.8388140000024578,1
225,8,3,5,1.2790529999911087,1
226,9,5,4,1.106058999997913,1
227,9,4,5,1.2979230000055395,1
228,10,3,7,2.6963439999963157,1
229,7,3,4,1.378261999998358,1
230,8,4,4,1.4162899999937508,1
231,8,2,6,0.7047140000067884,1
232,20,8,12,0.34936199999356177,1
233,13,5,8,0.7687460000015562,1
234,13,5,8,0.7856170000013663,1
235,5,3,2,1.52554100000998,1
236,13,6,7,0.8315659999934724,1
237,7,4,3,1.188282999995863,1
238,7,3,4,1.3397180000029039,1
239,11,5,6,0.8294529999984661,1
240,12,6,6,0.7809229999984382,1
241,7,3,4,1.3697640000027604,1
242,8,4,4,1.3199699999968288,1
243,7,3,4,1.3519099999975879,1
244,7,3,4,1.6838220000063302,1
245,8,3,5,0.90749599999981,1
246,7,2,5,1.0621609999943757,1
247,7,3,4,1.3170269999973243,1
248,7,4,3,1.32998100000259,1
249,10,4,6,0.8970889999909559,1
250,10,5,5,1.2424009999958798,1
251,10,5,5,1.5256660000013653,1
252,7,4,3,1.1515249999938533,1
253,7,3,4,1.2725729999947362,1
254,11,4,7,0.7768930000020191,1
255,14,7,7,0.7078590000019176,1
256,10,4,6,0.8807669999951031,1
257,4,2,2,1.0791410000092583,1
258,12,6,6,1.118015000000014,1
259,8,3,5,1.3413750000036089,1
260,7,4,3,0.8247060000139754,1
261,13,7,6,0.726120000006631,1
262,8,3,5,1.2614429999957792,1
263,8,4,4,1.6495389999909094,1
264,9,4,5,1.361644000004162,1
265,7,4,3,0.7924809999967692,1
266,9,5,4,1.1390690000116592,1
267,8,3,5,1.1421200000040699,1
268,11,7,4,1.069644999995944,1
269,7,3,4,1.315946000002441,1
270,6,4,2,0.7184110000089277,1
271,6,1,5,0.7585590000089724,1
272,7,2,5,1.118032000013045,1
273,6,2,4,1.1958550000126706,1
274,7,3,4,1.3443330000009155,1
275,6,3,3,0.9367919999931473,1
276,10,4,6,1.2642009999981383,1
277,9,4,5,0.9806339999922784,1
278,10,4,6,1.2827700000052573,1
279,6,2,4,2.1739380000071833,1
280,8,3,5,1.3098389999940991,1
281,7,4,3,1.2079420000081882,1
282,6,3,3,1.1019169999926817,1
283,13,6,7,0.7879280000051949,1
284,6,3,3,1.558117000007769,1
285,9,4,5,0.9787359999900218,1
286,11,4,7,0.7916669999976875,1
287,6,3,3,1.2778030000044964,1
288,10,4,6,1.2742700000089826,1
289,9,4,5,0.9615349999949103,1
290,10,5,5,0.8918180000036955,1
291,11,6,5,0.4050029999925755,1
292,9,4,5,0.9741680000006454,1
293,8,3,5,0.920732999991742,1
294,8,3,5,1.207038000007742,1
295,6,3,3,1.2397219999984372,1
296,5,2,3,1.6039850000088336,1
297,6,2,4,1.1817440000013448,1
298,10,5,5,0.8522670000093058,1
299,6,3,3,1.6201099999889266,1
300,5,2,3,1.6672580000013113,1
301,13,6,7,0.8207810000021709,1
302,9,4,5,0.9932949999929406,1
303,6,3,3,1.6084439999976894,1
304,13,6,7,0.8008540000009816,1
305,11,5,6,0.8859780000057071,1
306,12,5,7,0.8167089999915333,1
307,4,2,2,1.5910710000025574,1
308,7,4,3,1.2681869999942137,1
309,8,4,4,1.4143899999908172,1
310,12,5,7,0.8240209999930812,1
311,6,3,3,0.9228429999930086,1
312,10,4,6,0.9368820000090636,1
313,12,5,7,1.241810000006808,1
314,5,2,3,2.0360470000014175,1
315,8,4,4,0.9165510000020731,1
316,7,2,5,0.7500029999937396,1
317,8,4,4,1.285928999990574,1
318,13,6,7,0.7889029999932973,1
319,7,3,4,1.3632380000053672,1
320,7,3,4,1.3468490000086604,1
321,4,1,3,1.2003330000006827,1
322,9,4,5,0.9901099999988219,1
323,13,6,7,0.8120179999968968,1
324,8,3,5,1.454792999997153,1
325,8,4,4,1.2812340000091353,1
326,7,4,3,0.8330510000087088,1
327,8,4,4,2.10248300000967,1
328,12,5,7,0.842765999987023,1
329,6,3,3,1.2348110000020824,1
330,10,4,6,1.2378769999922952,1
331,8,3,5,0.9237329999887152,1
332,9,4,5,0.9628990000055637,1
333,15,6,9,0.7185620000091149,1
334,7,3,4,1.3092259999975795,1
335,13,6,7,0.7913669999979902,1
336,5,2,3,2.015486999996938,1
337,10,5,5,0.824161999989883,1
338,12,6,6,0.793294999995851,1
339,5,3,2,1.8370739999954822,1
340,8,3,5,0.8827750000054948,1
341,5,1,4,0.8099099999963073,1
342,12,5,7,0.8131569999968633,1
343,7,3,4,1.3201949999929639,1
344,11,2,9,0.7398370000009891,1
345,11,5,6,0.8449439999967581,1
346,17,9,8,0.7848709999962011,1
347,16,5,11,0.7241939999948954,1
348,12,5,7,1.1991149999957997,1
349,8,4,4,1.2722849999991013,1
350,11,5,6,0.8822159999981523,1
351,8,4,4,1.6302550000109477,1
352,7,2,5,1.1406960000022082,1
353,8,4,4,0.9220460000069579,1
354,8,3,5,3.1495130000112113,1
355,4,2,2,1.2176550000003772,1
356,9,4,5,1.0307130000001052,1
357,8,4,4,1.2472730000008596,1
358,9,4,5,0.9780460000038147,1
359,10,4,6,0.871329000001424,1
360,8,4,4,0.9423950000054901,1
361,9,4,5,1.3509869999979855,1
362,11,6,5,0.7946150000061607,1
363,10,4,6,1.3658730000024661,1
364,6,2,4,1.1827570000023115,1
365,7,3,4,1.3173969999916153,1
366,6,3,3,1.2848590000066906,1
367,7,3,4,1.4239549999911105,1
368,7,3,4,1.5934629999974277,1
369,6,2,4,1.5623799999884795,1
370,14,8,6,0.7514870000013616,1
371,9,5,4,1.2031519999873126,1
372,12,4,8,0.7789880000054836,1
373,5,3,2,1.2037249999993946,1
374,8,3,5,1.2789370000100462,1
375,6,3,3,1.2414089999947464,1
376,6,3,3,1.3102249999938067,1
377,6,2,4,1.1943989999999758,1
378,10,5,5,0.892178000009153,1
379,7,3,4,1.3701030000083847,1
380,11,5,6,1.1987039999949047,1
381,11,5,6,1.2376919999951497,1
382,8,4,4,1.6477969999978086,1
383,10,4,6,0.9113289999950211,1
384,6,3,3,1.2524339999945369,1
385,6,2,4,1.2773709999892162,1
386,7,4,3,1.2443879999918863,1
387,8,3,5,0.9290069999988191,1
388,12,6,6,0.8099749999964843,1
389,7,3,4,1.561256000000867,1
390,8,4,4,0.9094049999985145,1
391,11,4,7,0.7848010000016075,1
392,13,7,6,0.7355289999977686,1
393,11,5,6,0.837240999986534,1
394,9,4,5,2.0099820000032196,1
395,10,5,5,0.8606380000128411,1
396,8,4,4,1.3482729999959702,1
397,7,4,3,0.797759999986738,1
398,9,4,5,1.3621579999889946,1
399,8,3,5,1.2927550000022165,1
400,11,5,6,0.8162559999909718,1
401,11,5,6,1.179826999999932,1
402,10,4,6,1.2510229999898002,1
403,6,3,3,1.3179229999950621,1
404,10,5,5,0.8565549999912037,1
405,4,2,2,1.1884850000060396,1
406,15,8,7,0.7404400000086753,1
407,7,3,4,1.344837999989977,1
408,5,2,3,1.2888309999980265,1
409,10,5,5,0.911061000006157,1
410,9,4,5,1.367396000001463,1
411,9,3,6,0.874643000002834,1
412,11,6,5,1.1910610000049928,1
413,8,4,4,1.3884860000107437,1
414,8,3,5,1.5239800000126706,1
415,9,4,5,1.3788169999897946,1
416,8,3,5,1.6550050000078045,1
417,11,5,6,0.8889889999991283,1
418,10,4,6,1.2929560000047786,1
419,5,2,3,1.315338000000338,1
420,7,4,3,1.1758889999910025,1
421,7,3,4,1.3800970000011148,1
422,8,3,5,1.2785580000054324,1
423,15,7,8,0.7843690000008792,1
424,5,2,3,1.2818520000000717,1
425,7,3,4,1.0061149999964982,1
426,9,4,5,1.3666769999981625,1
427,12,6,6,2.8683531284332275,1
428,7,3,4,4.028080224990845,1
429,5,2,3,6.591023683547974,1
430,9,3,6,3.0225701332092285,1
431,9,4,5,3.8772010803222656,1
432,11,5,6,2.905574321746826,1
433,9,4,5,2.9137518405914307,1
434,5,2,3,3.911404609680176,1
435,10,5,5,4.030799627304077,1
436,7,3,4,4.225035905838013,1
437,8,4,4,4.755842447280884,1
438,6,3,3,3.2421376705169678,1
439,9,4,5,4.6264684200286865,1
440,7,4,3,4.352730989456177,1
441,10,5,5,3.1021945476531982,1
442,8,3,5,3.2724623680114746,1
443,6,2,4,4.9445884227752686,1
444,4,1,3,4.033034563064575,1
445,9,4,5,3.2404956817626953,1
446,9,4,5,2.8848459720611572,1
447,12,5,7,2.9628357887268066,1
448,8,3,5,2.893296718597412,1
449,9,4,5,3.077828884124756,1
450,10,4,6,3.1824378967285156,1
451,14,6,8,3.4834563732147217,1
452,8,3,5,2.981025457382202,1
453,11,5,6,3.353403091430664,1
454,11,4,7,3.550119638442993,1
455,12,7,5,3.034053087234497,1
456,10,4,6,3.040316104888916,1
457,8,4,4,3.8660359382629395,1
458,12,5,7,2.8858213424682617,1
459,7,4,3,3.6364638805389404,1
460,7,3,4,4.6310834884643555,1
461,11,6,5,4.688703775405884,1
462,8,5,3,3.510349988937378,1
463,6,3,3,4.2763800621032715,1
464,10,5,5,2.8117189407348633,1
465,11,4,7,2.9633238315582275,1
466,5,3,2,3.8499908447265625,1
467,9,4,5,3.1228957176208496,1
468,10,5,5,2.983377695083618,1
469,10,4,6,3.4171111583709717,1
470,5,2,3,4.94762659072876,1
471,12,6,6,2.7855985164642334,1
472,11,4,7,3.625410318374634,1
473,9,4,5,3.8779635429382324,1
474,9,5,4,3.6841981410980225,1
475,6,3,3,3.6495044231414795,1
476,12,6,6,2.952080011367798,1
477,7,3,4,4.959599733352661,1
478,6,3,3,4.421872615814209,1
479,8,4,4,3.0023434162139893,1
480,5,2,3,3.8460135459899902,1
481,8,3,5,2.882913112640381,1
482,11,5,6,3.9747893810272217,1
483,7,3,4,3.858504295349121,1
484,4,2,2,4.854089021682739,1
485,8,3,5,2.920543909072876,1
486,10,5,5,3.7453806400299072,1
487,7,3,4,4.432953834533691,1
488,5,2,3,4.346059560775757,1
489,13,6,7,2.9289891719818115,1
490,5,2,3,4.510646343231201,1
491,13,5,8,3.466895580291748,1
492,8,4,4,3.7643213272094727,1
493,7,4,3,4.936997652053833,1
494,11,5,6,3.085942029953003,1
495,5,1,4,3.5222551822662354,1
496,4,2,2,4.455618381500244,1
497,10,4,6,3.701409101486206,1
498,11,5,6,3.0512847900390625,1
499,9,4,5,3.969431161880493,1
500,7,3,4,3.7503433227539062,1
501,9,4,5,3.0076355934143066,1
502,8,4,4,4.547761917114258,1
503,7,3,4,5.901156425476074,1
504,10,4,6,3.675854206085205,1
505,7,3,4,2.945652484893799,1
506,5,2,3,4.669960975646973,1
507,7,3,4,3.9784624576568604,1
508,9,4,5,3.7508597373962402,1
509,8,4,4,3.674220323562622,1
510,10,4,6,2.8954052925109863,1
511,9,4,5,3.6476991176605225,1
512,9,5,4,3.2195472717285156,1
513,7,3,4,3.8085861206054688,1
514,7,2,5,3.01524019241333,1
515,7,3,4,3.0342278480529785,1
516,16,8,8,2.9616751670837402,1
517,5,2,3,3.648228406906128,1
518,6,4,2,2.950063943862915,1
519,7,4,3,3.325935125350952,1
520,10,4,6,3.867344379425049,1
521,6,3,3,3.1651647090911865,1
522,7,3,4,3.6299006938934326,1
523,8,4,4,3.022162437438965,1
524,10,5,5,3.659334182739258,1
525,9,4,5,3.761153221130371,1
526,8,4,4,3.9506349563598633,1
527,8,4,4,3.6881160736083984,1
528,10,4,6,3.808793067932129,1
529,7,3,4,3.729640483856201,1
530,8,4,4,4.477445840835571,1
531,13,7,6,3.590786933898926,1
532,7,3,4,3.654435634613037,1
533,8,3,5,4.107002258300781,1
534,7,3,4,4.384896516799927,1
535,12,5,7,3.0580320358276367,1
536,10,5,5,3.2367098331451416,1
537,5,2,3,3.6508941650390625,1
538,7,4,3,3.7499144077301025,1
539,8,4,4,4.762053966522217,1
540,7,4,3,4.151029586791992,1
541,18,9,9,2.879708766937256,1
542,8,3,5,3.7302377223968506,1
543,7,3,4,2.9733691215515137,1
544,4,2,2,4.968963384628296,1
545,7,2,5,3.935296058654785,1
546,10,5,5,4.237958908081055,1
547,6,2,4,3.7129905223846436,1
548,8,4,4,2.9211320877075195,1
549,7,3,4,3.7440567016601562,1
550,6,3,3,3.69718074798584,1
551,7,4,3,2.8173933029174805,1
552,7,3,4,3.3605051040649414,1
553,6,2,4,2.9766504764556885,1
554,5,2,3,4.023289442062378,1
555,10,5,5,2.9768083095550537,1
556,11,5,6,4.008317470550537,1
557,5,3,2,4.548953533172607,1
558,7,3,4,4.671329498291016,1
559,12,5,7,3.571800708770752,1
560,6,2,4,5.465181112289429,1
561,8,3,5,2.984130620956421,1
562,6,2,4,4.578740835189819,1
563,4,1,3,3.9152538776397705,1
564,4,2,2,4.250468492507935,1
565,8,3,5,4.244883060455322,1
566,8,4,4,4.1036858558654785,1
567,4,2,2,4.244883060455322,0
568,11,6,5,5.713986873626709,1
569,10,5,5,3.1029906272888184,1
570,12,5,7,3.0533554553985596,1
571,7,4,3,3.7609968185424805,1
572,7,4,3,3.8027491569519043,1
573,6,3,3,4.296604633331299,1
574,8,3,5,2.949737310409546,1
575,11,6,5,2.9846675395965576,1
576,10,4,6,3.781219244003296,1
577,10,4,6,3.85498309135437,1
578,8,3,5,3.629422426223755,1
579,10,4,6,2.9316253662109375,1
580,5,2,3,4.244883060455322,0
581,6,3,3,4.300854444503784,1
582,10,4,6,3.584289073944092,1
583,10,4,6,3.258580446243286,1
584,4,2,2,3.71927809715271,1
585,14,6,8,3.1806302070617676,1
586,9,4,5,3.564440965652466,1
587,11,3,8,2.98069429397583,1
588,9,4,5,3.464049816131592,1
589,5,1,4,3.8913073539733887,1
590,9,5,4,3.813504934310913,1
591,5,2,3,5.411927700042725,1
592,7,3,4,2.8882360458374023,1
593,10,4,6,3.570176362991333,1
594,8,4,4,4.419531583786011,1
595,7,4,3,3.566483497619629,1
596,11,5,6,3.003202199935913,1
597,6,3,3,3.8951056003570557,1
598,10,4,6,2.9131150245666504,1
599,10,4,6,3.4462430477142334,1
600,7,4,3,3.420262336730957,1
601,9,4,5,2.8826162815093994,1
602,8,3,5,3.674781322479248,1
603,7,3,4,3.8773698806762695,1
604,8,3,5,5.712973594665527,1
605,11,5,6,2.993486166000366,1
606,8,3,5,3.150911331176758,1
607,9,3,6,3.6558568477630615,1
608,10,5,5,4.775975704193115,1
609,7,3,4,4.262561321258545,1
610,10,4,6,3.3206827640533447,1
611,6,3,3,4.480397939682007,1
612,14,5,9,3.132291078567505,1
613,10,4,6,2.974058151245117,1
614,10,5,5,2.873703718185425,1
615,12,5,7,3.6116487979888916,1
616,9,4,5,4.11436915397644,1
617,12,6,6,2.9830400943756104,1
618,5,3,2,3.0767643451690674,1
619,13,6,7,3.0661942958831787,1
620,8,3,5,3.7236618995666504,1
621,10,5,5,3.3426027297973633,1
622,4,1,3,4.162054538726807,1
623,8,4,4,3.3201045989990234,1
624,10,4,6,3.814340353012085,1
625,10,4,6,3.199320077896118,1
626,11,5,6,4.510805130004883,1
627,8,3,5,3.2840399742126465,1
628,9,4,5,4.70349645614624,1
629,11,4,7,3.211048126220703,1
630,7,3,4,4.794862508773804,1
631,9,4,5,3.191042423248291,1
632,10,5,5,3.471245050430298,1
633,11,5,6,3.189563512802124,1
634,8,4,4,3.9893572330474854,1
635,13,5,8,3.084627151489258,1
636,7,3,4,4.192065954208374,1
637,8,5,3,3.6543338298797607,1
638,11,4,7,3.1103532314300537,1
639,10,4,6,4.145854473114014,1
640,5,2,3,5.43470025062561,1
641,6,3,3,4.884333372116089,1
642,4,2,2,4.466566801071167,1
643,8,4,4,4.018460512161255,1
644,6,3,3,4.026372671127319,1
645,10,5,5,3.1026785373687744,1
646,8,3,5,3.050502300262451,1
647,9,4,5,3.0625741481781006,1
648,9,3,6,3.471409797668457,1
649,4,1,3,3.2921335697174072,1
650,13,5,8,3.2087574005126953,1
651,13,7,6,3.35833477973938,1
652,12,5,7,3.7119998931884766,1
653,10,5,5,3.6775753498077393,1
654,6,3,3,4.177400827407837,1
655,5,2,3,3.572951316833496,1
656,7,3,4,4.377572298049927,1
657,15,6,9,3.747385025024414,1
658,8,4,4,4.001051187515259,1
659,13,6,7,3.2352707386016846,1
660,4,2,2,4.649235010147095,1
661,11,4,7,3.424525737762451,1
662,12,5,7,3.570310115814209,1
663,7,3,4,4.11538028717041,1
664,9,4,5,5.047581434249878,1
665,4,1,3,3.990694284439087,1
666,10,4,6,3.5247695446014404,1
667,10,4,6,3.8601505756378174,1
668,10,5,5,3.349179983139038,1
669,9,4,5,4.12654447555542,1
670,9,4,5,3.5614676475524902,1
671,5,1,4,3.356797695159912,1
672,10,4,6,3.6982038021087646,1
673,8,3,5,3.9338181018829346,1
674,9,6,3,2.978724718093872,1
675,8,3,5,3.194382905960083,1
676,13,6,7,3.110631227493286,1
677,6,3,3,4.046844959259033,1
678,8,5,3,4.175363540649414,1
679,7,4,3,4.097600936889648,1
680,8,3,5,5.096505403518677,1
681,6,2,4,4.444764614105225,1
682,8,3,5,3.9633703231811523,1
683,9,5,4,3.6554155349731445,1
684,10,6,4,4.079702615737915,1
685,8,3,5,4.009429454803467,1
686,10,4,6,3.1789050102233887,1
687,8,2,6,3.908872604370117,1
688,7,3,4,4.140471696853638,1
689,11,4,7,3.0981249809265137,1
690,6,3,3,4.476840496063232,1
691,5,3,2,5.308537721633911,1
692,7,3,4,3.92804217338562,1
693,7,3,4,4.803563833236694,1
694,12,6,6,3.0750482082366943,1
695,7,3,4,7.305339097976685,1
696,6,3,3,4.0236101150512695,1
697,6,3,3,4.03545880317688,1
698,15,5,10,3.73254132270813,1
699,10,4,6,4.36250638961792,1
700,9,3,6,3.2985739707946777,1
701,16,8,8,3.3475148677825928,1
702,11,4,7,3.6371071338653564,1
703,9,4,5,3.251077175140381,1
704,5,3,2,4.265608310699463,1
705,9,4,5,3.200486183166504,1
706,10,4,6,3.3191940784454346,1
707,8,3,5,3.793689489364624,1
708,8,4,4,4.80670166015625,1
709,9,4,5,4.091902732849121,1
710,8,5,3,3.4727675914764404,1
711,12,6,6,3.202030897140503,1
712,12,4,8,3.3284928798675537,1
713,7,3,4,3.706139326095581,1
714,12,5,7,3.4619710445404053,1
715,7,4,3,5.015296936035156,1
716,4,2,2,4.381321907043457,1
717,8,4,4,4.410663843154907,1
718,6,2,4,6.694259881973267,1
719,9,4,5,3.2631676197052,1
720,9,4,5,3.9949452877044678,1
721,8,3,5,4.264145612716675,1
722,8,3,5,3.6263232231140137,1
723,10,5,5,3.8322415351867676,1
724,10,4,6,4.046367406845093,1
725,9,4,5,3.125464916229248,1
726,8,3,5,3.951188802719116,1
727,12,4,8,3.575782537460327,1
728,17,9,8,4.1729512214660645,1
729,8,4,4,3.9195480346679688,1
730,8,5,3,3.3662121295928955,1
731,6,1,5,3.8727262020111084,1
732,7,3,4,3.4789743423461914,1
733,7,3,4,3.1729512214660645,0
734,10,5,5,0.0009989738464355469,1
735,10,5,5,2.3733768463134766,1
736,6,3,3,0.0010027885437011719,1
737,6,3,3,2.9803061485290527,1
738,8,4,4,2.311525821685791,1
739,13,5,8,1.7735974788665771,1
740,7,5,2,2.6693243980407715,1
741,9,4,5,3.1780171394348145,1
742,15,7,8,0.863997220993042,1
743,9,5,4,1.7200274467468262,1
744,8,4,4,3.378638744354248,1
745,10,4,6,2.497879981994629,1
746,10,4,6,3.6882007122039795,1
747,8,4,4,4.507467746734619,1
748,8,3,5,3.0748844146728516,1
749,10,5,5,2.972181797027588,1
750,7,3,4,4.714792490005493,1
751,9,4,5,2.6425135135650635,1
752,7,4,3,3.9570372104644775,1
753,5,3,2,6.553651809692383,1
754,4,3,1,2.561912775039673,1
755,6,3,3,3.6561567783355713,1
756,5,2,3,2.879612684249878,1
757,10,4,6,1.700463056564331,1
758,7,4,3,2.243786334991455,1
759,5,2,3,12.338533163070679,0
760,7,3,4,3.038541078567505,1
761,6,2,4,2.256086826324463,1
762,8,3,5,2.3108301162719727,1
763,10,5,5,2.183603048324585,1
764,7,3,4,2.4039230346679688,1
765,7,4,3,1.5995354652404785,1
766,7,3,4,1.6344983577728271,1
767,4,1,3,2.279445171356201,1
768,7,4,3,3.005300998687744,1
769,7,3,4,1.4814784526824951,1
770,9,3,6,2.681576728820801,1
771,8,4,4,1.5675108432769775,1
772,5,2,3,4.166833400726318,0
773,9,4,5,2.444028615951538,1
774,10,2,8,1.5412044525146484,1
775,6,2,4,2.3816030025482178,1
776,7,3,4,4.573164224624634,1
777,13,6,7,1.6393380165100098,1
778,9,4,5,2.5407464504241943,1
779,14,6,8,2.3185153007507324,1
780,8,4,4,4.098862648010254,1
781,7,4,3,5.033550262451172,1
782,8,3,5,4.75062108039856,1
783,4,2,2,6.35119366645813,0
784,7,2,5,1.965101718902588,1
785,4,2,2,3.995516061782837,1
786,6,2,4,5.363212585449219,0
787,10,5,5,3.3802857398986816,1
788,4,2,2,4.8568572998046875,0
789,6,3,3,5.226798057556152,1
790,13,6,7,2.7640552520751953,1
791,6,3,3,4.128720998764038,1
792,10,4,6,5.236976146697998,1
793,8,3,5,5.4214558601379395,1
794,8,3,5,3.2028188705444336,1
795,8,3,5,1.8900775909423828,1
796,6,3,3,4.915449380874634,0
797,9,4,5,4.196905612945557,1
798,10,4,6,3.480844259262085,1
799,9,4,5,2.998211622238159,1
800,11,4,7,2.0485341548919678,1
801,8,3,5,2.7884323596954346,1
802,5,2,3,3.0842397212982178,1
803,10,5,5,3.0734996795654297,1
804,8,4,4,5.73388409614563,1
805,5,2,3,5.670159578323364,0
806,10,4,6,4.467525243759155,1
807,12,5,7,4.200595140457153,1
808,6,2,4,5.016253471374512,1
809,12,4,8,3.4827651977539062,1
810,9,4,5,7.527367353439331,1
811,5,2,3,3.3745782375335693,1
812,13,4,9,1.721015214920044,1
813,7,2,5,2.5445547103881836,1
814,7,3,4,4.196932792663574,1
815,7,3,4,5.038268089294434,1
816,7,2,5,3.4783711433410645,1
817,7,4,3,4.068500757217407,1
818,8,4,4,4.021588325500488,0
819,7,3,4,3.9886813163757324,1
820,7,3,4,2.58097243309021,1
821,12,5,7,2.9789140224456787,1
822,8,2,6,3.0716094970703125,1
823,13,6,7,1.635852575302124,1
824,9,3,6,1.6368868350982666,1
825,6,3,3,3.178853750228882,1
826,17,8,9,1.6379084587097168,1
827,9,3,6,4.010630369186401,1
828,6,2,4,10.956509828567505,1
829,7,3,4,4.326694011688232,1
830,14,8,6,1.4777250289916992,1
831,11,5,6,12.078635215759277,1
832,9,4,5,3.112962245941162,1
833,9,4,5,3.7432472705841064,1
834,6,3,3,2.5912458896636963,1
835,10,4,6,2.0251922607421875,1
836,6,3,3,3.666180372238159,1
837,10,5,5,1.7536940574645996,1
838,8,4,4,3.6857781410217285,1
839,8,4,4,9.22145676612854,1
840,12,5,7,3.7933881282806396,1
841,10,5,5,2.5601401329040527,1
842,11,4,7,2.4585189819335938,1
843,6,2,4,4.008479356765747,1
844,9,4,5,2.8650388717651367,1
845,11,4,7,2.3866193294525146,1
846,10,5,5,1.594895601272583,1
847,6,2,4,3.7836971282958984,1
848,12,6,6,2.6747629642486572,1
849,7,4,3,3.595578193664551,1
850,9,4,5,3.275956392288208,1
851,8,4,4,2.3921618461608887,1
852,8,4,4,4.099280595779419,1
853,10,4,6,3.4937028884887695,1
854,5,2,3,2.8677470684051514,1
855,8,4,4,3.585581064224243,1
856,10,5,5,2.7924556732177734,1
857,9,4,5,2.0728061199188232,1
858,6,3,3,3.998852014541626,1
859,6,2,4,3.4820549488067627,1
860,10,4,6,2.7714102268218994,1
861,8,3,5,2.4602434635162354,1
862,10,5,5,2.4315288066864014,1
863,5,2,3,5.319257020950317,0
864,9,4,5,0.8186249732971191,1
865,10,5,5,2.3315794467926025,1
866,6,3,3,2.5296876430511475,1
867,8,4,4,4.189262628555298,1
868,7,2,5,2.567685604095459,1
869,9,3,6,3.4716315269470215,1
870,9,4,5,2.9757754802703857,1
871,8,2,6,2.457477569580078,1
872,11,5,6,2.559422254562378,1
873,13,6,7,2.8800089359283447,1
874,9,5,4,1.7455148696899414,1
875,9,2,7,1.9447369575500488,1
876,10,4,6,2.3540139198303223,1
877,9,4,5,2.8824143409729004,1
878,8,3,5,3.380384683609009,1
879,7,3,4,4.294389009475708,1
880,12,6,6,2.2474679946899414,1
881,8,4,4,4.489210367202759,1
882,7,3,4,3.5667927265167236,1
883,10,5,5,3.294194459915161,1
884,11,5,6,1.7454535961151123,1
885,8,3,5,3.1747469902038574,1
886,10,4,6,2.4828953742980957,1
887,10,5,5,1.6421668529510498,1
888,7,3,4,4.055577278137207,0
889,6,3,3,5.119420051574707,1
890,6,3,3,3.8888652324676514,1
891,10,5,5,2.480882406234741,1
892,12,5,7,7.344521999359131,1
893,7,3,4,152.59637761116028,1
894,12,5,7,2.196845769882202,1
895,8,3,5,3.9282991886138916,1
896,10,4,6,2.9727132320404053,1
897,10,4,6,3.144676685333252,1
898,14,6,8,2.535172700881958,1
899,10,6,4,4.453846454620361,1
900,8,4,4,3.6472389698028564,1
901,9,5,4,3.889434576034546,1
902,9,4,5,2.9127376079559326,1
903,5,2,3,2.215632200241089,1
904,8,3,5,2.364959478378296,1
905,6,2,4,2.2005789279937744,1
906,10,4,6,4.070860385894775,1
907,12,5,7,1.496467113494873,1
908,13,6,7,2.2497003078460693,1
909,7,3,4,3.047077178955078,1
910,8,4,4,3.4131572246551514,1
911,12,5,7,2.3535797595977783,1
912,12,4,8,1.6415050029754639,1
913,7,2,5,2.313870429992676,1
914,9,4,5,2.275108814239502,1
915,7,4,3,3.3142237663269043,1
916,12,6,6,2.596893072128296,1
917,10,4,6,1.4583210945129395,1
918,8,3,5,4.46249794960022,1
919,9,4,5,2.15702223777771,1
920,6,3,3,2.852443218231201,1
921,7,3,4,5.429505825042725,1
922,9,4,5,2.524519920349121,1
923,7,3,4,3.0502402782440186,1
924,16,7,9,1.4455296993255615,1
925,10,5,5,2.332578182220459,1
926,13,6,7,1.3997554779052734,1
927,10,4,6,2.340778350830078,1
928,7,3,4,4.418160915374756,1
929,9,3,6,1.6612932682037354,1
930,11,5,6,2.1837756633758545,1
931,9,4,5,4.253996133804321,1
932,9,4,5,2.918644428253174,1
933,10,5,5,1.4242877960205078,1
934,10,4,6,2.4034996032714844,1
935,11,5,6,2.375272274017334,1
936,11,5,6,1.4705064296722412,1
937,5,2,3,3.649608850479126,0
938,5,2,3,4.709491729736328,1
939,10,4,6,2.200056314468384,1
940,9,5,4,2.1575605869293213,1
941,5,1,4,4.743739128112793,1
942,11,5,6,2.656900644302368,1
943,4,2,2,3.684532403945923,0
944,9,4,5,2.8523144721984863,1
945,9,4,5,4.119682550430298,1
946,5,3,2,5.89934229850769,1
947,8,4,4,4.165956020355225,1
948,8,4,4,3.1924476623535156,1
949,6,3,3,2.1942384243011475,1
950,11,5,6,4.24491286277771,1
951,8,3,5,2.2752623558044434,1
952,5,1,4,4.3792564868927,1
953,7,4,3,4.596338510513306,1
954,8,4,4,4.299381256103516,1
955,8,4,4,3.9331653118133545,0
956,14,6,8,2.499511480331421,1
957,6,3,3,6.540075778961182,1
958,8,3,5,2.3216657638549805,1
959,8,3,5,2.1934971809387207,1
960,9,4,5,3.115457773208618,1
961,6,1,5,1.4249684810638428,1
962,13,6,7,2.2043297290802,1
963,7,3,4,5.7679853439331055,1
964,10,4,6,4.119607210159302,1
965,10,4,6,5.10483717918396,1
966,8,2,6,3.2769711017608643,1
967,6,3,3,7.680582761764526,1
968,9,5,4,3.1000726222991943,1
969,5,2,3,5.732359886169434,0
970,9,3,6,6.957744121551514,1
971,15,7,8,1.9452683925628662,1
972,9,4,5,3.8943846225738525,1
973,7,3,4,5.1745686531066895,1
974,5,2,3,3.172877550125122,1
975,8,3,5,4.397719621658325,1
976,10,4,6,3.995896816253662,1
977,5,3,2,3.0722508430480957,1
978,7,3,4,4.407244443893433,1
979,8,3,5,4.714273691177368,1
980,10,4,6,4.201812267303467,1
981,13,6,7,2.0155186653137207,1
982,12,6,6,2.933591604232788,1
983,11,4,7,1.948965311050415,1
984,7,3,4,4.505801677703857,1
985,11,5,6,2.557295083999634,1
986,11,5,6,3.091383934020996,1
987,7,3,4,3.179912805557251,1
988,9,4,5,5.8359808921813965,1
989,5,2,3,7.018324613571167,1
990,6,3,3,4.193523645401001,1
991,15,8,7,4.319220542907715,1
992,5,2,3,8.403597354888916,1
993,7,3,4,2.397047519683838,1
994,8,2,6,2.5983645915985107,1
995,9,4,5,3.619119882583618,1
996,10,5,5,2.954915761947632,1
997,10,4,6,2.2622435092926025,1
998,10,3,7,2.1424357891082764,1
999,6,3,3,2.85675048828125,1
1000,8,4,4,3.622089147567749,1
1001,11,4,7,2.5455245971679688,1
1002,13,5,8,2.1685562133789062,1
1003,9,4,5,2.222904920578003,1
1004,8,4,4,2.18984317779541,1
1005,13,6,7,2.1207518577575684,1
1006,8,4,4,2.83652663230896,1
1007,8,3,5,2.1229794025421143,1
1008,10,4,6,2.127861738204956,1
1009,12,6,6,7.39689564704895,1
1010,6,3,3,5.344452619552612,1
1011,4,2,2,10.187756538391113,0
1012,8,4,4,5.117748975753784,1
1013,12,5,7,7.063923358917236,1
1014,8,3,5,7.379420280456543,1
1015,6,2,4,5.3287742137908936,1
1016,8,3,5,6.147821426391602,1
1017,5,2,3,5.119531154632568,1
1018,9,4,5,9.15326452255249,1
1019,9,3,6,3.993271589279175,1
1020,6,1,5,2.148167848587036,1
1021,6,3,3,11.013768911361694,1
1022,8,4,4,3.788334369659424,1
1023,9,4,5,2.5601449012756348,1
1024,8,2,6,5.618809223175049,1
1025,15,6,9,4.134141206741333,1
1026,8,4,4,6.043973684310913,1
1027,14,6,8,2.030844211578369,1
1028,6,3,3,3.489553451538086,1
1029,12,6,6,2.283686876296997,1
1030,7,3,4,3.1722452640533447,1
1031,5,3,2,3.8923757076263428,1
1032,7,3,4,4.757466077804565,1
1033,10,5,5,5.324521780014038,1
1034,7,2,5,2.3508286476135254,1
1035,6,3,3,5.120317220687866,1
1036,4,2,2,4.094092130661011,0
1037,8,4,4,3.968930244445801,1
1038,8,4,4,2.878803014755249,1
1039,11,5,6,1.7257537841796875,1
1040,8,2,6,3.5576722621917725,1
1041,4,2,2,4.108063220977783,0
1042,9,4,5,3.2814688682556152,1
1043,8,3,5,3.4551002979278564,1
1044,8,3,5,3.2932510375976562,1
1045,11,5,6,2.3901586532592773,1
1046,5,2,3,3.989880084991455,0
1047,9,4,5,3.3314051628112793,1
1048,7,3,4,1.543886423110962,1
1049,6,3,3,3.937936782836914,0
1050,11,5,6,1.582707166671753,1
1051,9,5,4,2.3215155601501465,1
1052,9,5,4,3.1775760650634766,1
1053,8,3,5,2.399250030517578,1
1054,8,4,4,1.6459319591522217,1
1055,7,2,5,1.6195099353790283,1
1056,7,4,3,3.106804847717285,1
1057,10,4,6,2.3637616634368896,1
1058,11,5,6,1.6753671169281006,1
1059,7,3,4,3.92010235786438,1
1060,7,4,3,3.803863525390625,1
1061,7,2,5,0.8215842247009277,1
1062,7,3,4,1.1955821514129639,1
1063,16,6,10,0.8263368606567383,1
1064,6,2,4,1.2293362617492676,1
1065,12,6,6,0.782261848449707,1
1066,11,4,7,0.8106632232666016,1
1067,5,1,4,2.045578718185425,1
1068,6,2,4,1.2710199356079102,1
1069,10,5,5,0.8185479640960693,1
1070,10,6,4,0.8329989910125732,1
1071,9,4,5,1.232891321182251,1
1072,9,4,5,0.8629050254821777,1
1073,10,4,6,0.803980827331543,1
1074,8,3,5,1.2131166458129883,1
1075,5,3,2,1.1989901065826416,1
1076,5,3,2,1.248713493347168,1
1077,8,4,4,1.7002882957458496,1
1078,7,3,4,1.2438888549804688,1
1079,7,3,4,1.2795965671539307,1
1080,9,5,4,0.8065590858459473,1
1081,6,3,3,2.382936954498291,1
1082,7,2,5,0.798945426940918,1
1083,11,5,6,0.8600728511810303,1
1084,5,2,3,2.1434690952301025,1
1085,7,4,3,1.4596543312072754,1
1086,6,3,3,0.838524341583252,1
1087,12,4,8,0.8953804969787598,1
1088,9,4,5,1.418168544769287,1
1089,9,4,5,0.8500697612762451,1
1090,5,2,3,1.6659860610961914,1
1091,8,4,4,0.8781275749206543,1
1092,11,3,8,0.8444287776947021,1
1093,13,5,8,0.8643128871917725,1
1094,8,4,4,0.8344614505767822,1
1095,15,7,8,0.7899529933929443,1
1096,12,6,6,0.8393590450286865,1
1097,11,4,7,1.3322598934173584,1
1098,16,7,9,0.8406021595001221,1
1099,8,3,5,1.3423805236816406,1
1100,10,4,6,1.2006967067718506,1
1101,8,4,4,0.8659288883209229,1
1102,8,4,4,1.2019338607788086,1
1103,7,3,4,1.2487735748291016,1
1104,10,5,5,0.829601526260376,1
1105,9,5,4,1.2426037788391113,1
1106,6,3,3,1.9888975620269775,1
1107,11,4,7,0.814673900604248,1
1108,7,3,4,0.8436923027038574,1
1109,7,3,4,1.1754024028778076,1
1110,5,2,3,0.8983964920043945,1
1111,11,5,6,0.9388682842254639,1
1112,7,4,3,1.2724254131317139,1
1113,6,3,3,1.247861385345459,1
1114,10,5,5,0.8034412860870361,1
1115,10,5,5,0.8293051719665527,1
1116,11,6,5,0.818535327911377,1
1117,6,4,2,0.836498498916626,1
1118,8,5,3,1.5714452266693115,1
1119,7,3,4,1.2327492237091064,1
1120,9,4,5,1.1879968643188477,1
1121,6,2,4,1.1779627799987793,1
1122,7,3,4,1.2509956359863281,1
1123,5,3,2,1.5417017936706543,1
1124,18,7,11,0.8745846748352051,1
1125,7,2,5,0.8640344142913818,1
1126,6,3,3,1.2993240356445312,1
1127,7,2,5,0.8574531078338623,1
1128,9,4,5,1.2896347045898438,1
1129,7,3,4,1.3684089183807373,1
1130,15,7,8,0.7893660068511963,1
1131,8,3,5,0.8330879211425781,1
1132,11,5,6,0.8729579448699951,1
1133,10,5,5,0.8462615013122559,1
1134,11,5,6,0.8475959300994873,1
1135,4,2,2,2.018282175064087,1
1136,11,5,6,1.0163631439208984,1
1137,11,6,5,1.2311415672302246,1
1138,14,7,7,0.818134069442749,1
1139,6,3,3,1.6397881507873535,1
1140,4,2,2,0.841266393661499,1
1141,13,6,7,0.8659820556640625,1
1142,4,2,2,1.2036633491516113,1
1143,11,4,7,0.8056542873382568,1
1144,10,5,5,0.7975537776947021,1
1145,7,3,4,1.2166807651519775,1
1146,6,3,3,0.8665146827697754,1
1147,9,5,4,0.844902515411377,1
1148,8,3,5,1.2205073833465576,1
1149,5,2,3,1.911463737487793,1
1150,10,4,6,0.7896714210510254,1
1151,4,2,2,1.2452900409698486,1
1152,9,4,5,1.2145195007324219,1
1153,13,7,6,0.7932491302490234,1
1154,10,4,6,0.8372411727905273,1
1155,10,5,5,1.2715866565704346,1
1156,7,3,4,1.6420762538909912,1
1157,6,2,4,1.6036992073059082,1
1158,11,5,6,0.834402322769165,1
1159,11,5,6,0.8592166900634766,1
1160,6,3,3,1.3094110488891602,1
1161,9,2,7,1.5462322235107422,1
1162,13,6,7,1.1363327503204346,1
1163,7,3,4,1.2095086574554443,1
1164,9,4,5,0.7974836826324463,1
1165,10,5,5,0.7618236541748047,1
1166,9,4,5,0.8226392269134521,1
1167,9,4,5,0.7982313632965088,1
1168,9,5,4,0.927323579788208,1
1169,8,3,5,1.133443832397461,1
1170,9,5,4,0.8431425094604492,1
1171,7,3,4,1.1673479080200195,1
1172,5,3,2,1.1185581684112549,1
1173,7,4,3,1.54075288772583,1
1174,11,5,6,0.9786014556884766,1
1175,12,5,7,0.8582634925842285,1
1176,11,5,6,0.7825491428375244,1
1177,5,2,3,1.101227045059204,1
1178,9,4,5,1.1025104522705078,1
1179,6,3,3,1.9196622371673584,1
1180,4,3,1,0.7585160732269287,1
1181,10,5,5,0.7859885692596436,1
1182,6,4,2,0.7878968715667725,1
1183,7,3,4,1.142498254776001,1
1184,5,3,2,0.7708480358123779,1
1185,6,2,4,1.1256561279296875,1
1186,10,4,6,0.761979341506958,1
1187,8,3,5,1.1613707542419434,1
1188,8,3,5,0.7853517532348633,1
1189,5,2,3,1.4595911502838135,1
1190,6,3,3,1.4926555156707764,1
1191,12,5,7,0.8798801898956299,1
1192,10,4,6,0.777085542678833,1
1193,11,5,6,0.8397068977355957,1
1194,5,2,3,1.5753593444824219,1
1195,8,3,5,0.8256208896636963,1
1196,8,3,5,0.7906622886657715,1
1197,11,5,6,1.1261839866638184,1
1198,6,2,4,1.5030927658081055,1
1199,10,4,6,0.839613676071167,1
1200,9,4,5,0.8916165828704834,1
1201,9,4,5,0.8017270565032959,1
1202,13,6,7,0.7668895721435547,1
1203,7,4,3,0.790642499923706,1
1204,14,7,7,0.7548022270202637,1
1205,10,4,6,0.7974309921264648,1
1206,9,3,6,0.8006298542022705,1
1207,7,3,4,1.138606071472168,1
1208,10,4,6,0.8446998596191406,1
1209,12,5,7,0.8123183250427246,1
1210,7,3,4,1.3513882160186768,1
1211,5,3,2,8,1
1212,10,5,5,6,1
1213,11,5,6,3,1
1214,6,2,4,3,1
1215,10,4,6,3,1
1216,15,5,10,3,1
1217,10,4,6,3,1
1218,5,2,3,4,1
1219,10,5,5,5,1
1220,12,5,7,7,1
1221,6,2,4,5,1
1222,5,2,3,15,1
1223,10,5,5,11,1
1224,8,3,5,11,1
1225,12,4,8,11,1
1226,13,7,6,5,1
1227,9,5,4,6,1
1228,10,4,6,6,1
1229,10,4,6,7,1
1230,9,3,6,6,1
1231,6,3,3,5,1
1232,8,4,4,5,1
1233,9,5,4,3,1
1234,7,3,4,3,1
1235,5,2,3,3,1
1236,12,5,7,6,1
1237,9,3,6,3,1
1238,5,2,3,3,1
1239,5,3,2,3,1
1240,4,1,3,4,1
1241,5,1,4,3,1
1242,14,6,8,3,1
1243,7,3,4,4,1
1244,11,5,6,3,1
1245,6,3,3,4,1
1246,7,2,5,2,1
1247,10,4,6,3,1
1248,5,2,3,3,1
1249,13,6,7,4,1
1250,5,2,3,6,1
1251,10,5,5,3,1
1252,11,5,6,3,1
1253,8,3,5,5,1
1254,5,3,2,3,1
1255,6,2,4,3,1
1256,8,4,4,4,1
1257,5,2,3,5,1
1258,9,5,4,3,1
1259,4,2,2,3,1
1260,12,6,6,3,1
1261,10,5,5,3,1
1262,7,4,3,4,1
1263,6,2,4,3,1
1264,9,5,4,4,1
1265,11,6,5,3,1
1266,11,5,6,3,1
1267,10,4,6,3,1
1268,11,5,6,3,1
1269,9,5,4,2,1
1270,8,3,5,3,1
1271,5,2,3,4,1
1272,7,3,4,4,1
1273,7,3,4,4,1
1274,10,4,6,3,1
1275,8,4,4,4,1
1276,4,2,2,6,1
1277,10,4,6,3,1
1278,8,4,4,4,1
1279,5,2,3,4,1
1280,10,4,6,3,1
1281,10,5,5,3,1
1282,10,4,6,3,1
1283,9,4,5,3,1
1284,8,4,4,3,1
1285,9,4,5,4,1
1286,7,4,3,4,1
1287,5,2,3,3,1
1288,4,2,2,5,1
1289,13,6,7,3,1
1290,10,5,5,5,1
1291,10,4,6,3,1
1292,9,4,5,4,1
1293,6,3,3,5,1
1294,10,4,6,3,1
1295,10,4,6,3,1
1296,9,4,5,4,1
1297,6,4,2,3,1
1298,14,6,8,3,1
1299,6,3,3,3,1
1300,9,3,6,2,1
1301,12,6,6,3,1
1302,8,4,4,4,1
1303,6,2,4,4,1
1304,7,4,3,4,1
1305,15,6,9,3,1
1306,8,4,4,4,1
1307,10,4,6,4,1
1308,9,4,5,4,1
1309,11,5,6,3,1
1310,8,3,5,3,1
1311,7,3,4,4,1
1312,7,3,4,3,1
1313,11,5,6,3,1
1314,7,3,4,3,1
1315,13,6,7,3,1
1316,9,5,4,3,1
1317,9,4,5,3,1
1318,13,5,8,2,1
1319,5,2,3,5,1
1320,7,3,4,4,1
1321,6,2,4,2,1
1322,6,3,3,3,1
1323,7,3,4,4,1
1324,8,3,5,3,1
1325,12,6,6,3,1
1326,9,4,5,4,1
1327,12,5,7,3,1
1328,11,4,7,3,1
1329,11,5,6,3,1
1330,11,4,7,3,1
1331,9,4,5,4,1
1332,11,5,6,3,1
1333,11,5,6,3,1
1334,6,3,3,3,1
1335,10,5,5,4,1
1336,5,2,3,4,1
1337,8,4,4,4,1
1338,11,5,6,4,1
1339,4,2,2,4,1
1340,5,2,3,4,1
1341,6,3,3,5,1
1342,7,3,4,4,1
1343,10,4,6,3,1
1344,17,8,9,3,1
1345,7,4,3,3,1
1346,11,5,6,3,1
1347,15,7,8,3,1
1348,9,3,6,3,1
1349,5,2,3,3,1
1350,11,5,6,3,1
1351,7,4,3,3,1
1352,10,4,6,3,1
1353,15,7,8,3,1
1354,9,4,5,5,1
1355,7,3,4,5,1
1356,4,1,3,4,1
1357,6,3,3,4,1
1358,7,4,3,4,1
1359,11,4,7,3,1
1360,6,3,3,4,1
1361,8,4,4,3,1
1362,10,4,6,3,1
1363,8,4,4,4,1
1364,7,4,3,4,1
1365,9,5,4,3,1
1366,15,6,9,3,1
1367,5,3,2,3,1
1368,5,2,3,3,1
1369,11,5,6,4,1
1370,8,3,5,4,1
1371,11,5,6,3,1
1372,10,4,6,4,1
1373,7,3,4,4,1
1374,15,7,8,3,1
1375,5,3,2,3,1
1376,6,3,3,4,1
1377,9,5,4,4,1
1378,5,2,3,3,1
1379,10,3,7,2,1
1380,9,3,6,2,1
1381,8,3,5,3,1
1382,11,4,7,3,1
1383,6,3,3,3,1
1384,14,6,8,2,1
1385,10,5,5,7,1
1386,7,2,5,5,1
1387,14,7,7,4,1
1388,8,4,4,4,1
1389,9,2,7,3,1
1390,5,2,3,5,1
1391,11,5,6,3,1
1392,10,4,6,3,1
1393,11,5,6,3,1
1394,10,4,6,3,1
1395,4,2,2,6,0
1396,7,4,3,4,1
1397,12,5,7,3,1
1398,7,3,4,4,1
1399,11,5,6,3,1
1400,6,2,4,4,1
1401,7,3,4,4,1
1402,8,3,5,3,1
1403,6,2,4,6,1
1404,10,5,5,4,1
1405,11,5,6,3,1
1406,6,3,3,4,1
1407,8,3,5,3,1
1408,8,4,4,4,1
1409,4,2,2,4,1
1410,8,4,4,3,1
1411,9,4,5,4,1
1412,9,4,5,4,1
1413,6,3,3,5,1
1414,6,2,4,4,1
1415,7,3,4,3,1
1416,12,5,7,3,1
1417,12,5,7,3,1
1418,11,5,6,3,1
1419,11,5,6,4,1
1420,7,4,3,4,1
1421,12,5,7,4,1
1422,10,5,5,4,1
1423,12,5,7,3,1
1424,4,2,2,6,1
1425,7,3,4,4,1
1426,7,2,5,3,1
1427,13,6,7,4,1
1428,7,3,4,4,1
1429,7,3,4,3,1
1430,6,3,3,6,1
1431,5,3,2,4,1
1432,15,7,8,3,1
1433,7,3,4,4,1
1434,10,5,5,3,1
1435,5,2,3,4,1
1436,9,4,5,4,1
1437,8,4,4,4,1
1438,8,3,5,4,1
1439,6,3,3,6,1
1440,9,4,5,5,1
1441,9,4,5,4,1
1442,7,4,3,4,1
1443,7,3,4,6,1
1444,9,3,6,4,1
1445,4,2,2,4,1
1446,8,3,5,3,1
1447,8,4,4,3,1
1448,9,4,5,4,1
1449,10,4,6,4,1
1450,11,4,7,3,1
1451,13,6,7,3,1
1452,11,4,7,3,1
1453,10,4,6,3,1
1454,10,5,5,4,1
1455,7,3,4,4,1
1456,7,3,4,4,1
1457,7,2,5,4,1
1458,4,2,2,5,1
1459,7,3,4,3,1
1460,9,4,5,5,1
1461,7,2,5,5,1
1462,14,6,8,3,1
1463,11,6,5,3,1
1464,8,4,4,5,1
1465,10,5,5,3,1
1466,10,5,5,4,1
1467,4,2,2,4,1
1468,9,5,4,3,1
1469,10,4,6,3,1
1470,7,3,4,4,1
1471,5,2,3,4,1
1472,10,5,5,3,1
1473,7,3,4,6,1
1474,10,5,5,5,1
1475,7,3,4,9,1
1476,9,4,5,4,1
1477,7,3,4,6,1
1478,11,5,6,5,1
1479,12,6,6,6,1
1480,7,3,4,5,1
1481,7,3,4,5,1
1482,7,3,4,7,1
1483,6,2,4,5,1
1484,10,4,6,5,1
1485,8,3,5,7,1
1486,6,3,3,5,1
1487,12,5,7,4,1
1488,7,3,4,4,1
1489,6,3,3,4,1
1490,6,3,3,4,1
1491,8,4,4,4,1
1492,7,3,4,3,1
1493,8,3,5,3,1
1494,11,5,6,4,1
1495,5,3,2,4,1
1496,6,3,3,4,1
1497,11,4,7,4,1
1498,10,4,6,4,1
1499,9,4,5,4,1
1500,6,3,3,4,1
1501,10,4,6,4,1
1502,11,5,6,3,1
1503,14,7,7,3,1
1504,9,4,5,4,1
1505,9,4,5,3,1
1506,6,2,4,5,1
1507,14,6,8,3,1
1508,7,2,5,3,1
1509,7,3,4,5,1
1510,13,6,7,3,1
1511,9,4,5,4,1
1512,10,4,6,3,1
1513,7,3,4,4,1
1514,7,3,4,5,1
1515,6,3,3,5,1
1516,7,3,4,4,1
1517,5,3,2,4,1
1518,10,5,5,3,1
1519,11,4,7,4,1
1520,12,5,7,3,1
1521,9,4,5,3,1
1522,8,5,3,3,1
1523,7,4,3,4,1
1524,10,4,6,3,1
1525,8,3,5,3,1
1526,11,5,6,3,1
1527,10,5,5,4,1
1528,5,3,2,5,1
1529,6,3,3,4,1
1530,12,5,7,3,1
1531,9,4,5,4,1
1532,9,4,5,4,1
1533,5,3,2,4,1
1534,11,5,6,3,1
1535,10,5,5,4,1
1536,9,4,5,3,1
1537,4,2,2,3,1
1538,9,4,5,4,1
1539,11,4,7,3,1
1540,8,4,4,3,1
1541,8,4,4,4,1
1542,7,3,4,4,1
1543,7,4,3,4,1
1544,4,1,3,3,1
1545,5,3,2,3,1
1546,5,2,3,6,1
1547,5,2,3,4,1
1548,7,4,3,3,1
1549,8,3,5,3,1
1550,7,2,5,4,1
1551,4,2,2,5,1
1552,10,4,6,4,1
1553,17,8,9,3,1
1554,6,3,3,5,1
1555,10,5,5,3,1
1556,10,4,6,3,1
1557,11,5,6,3,1
1558,9,3,6,3,1
1559,4,2,2,4,1
1560,9,4,5,4,1
1561,6,2,4,3,1
1562,8,4,4,5,1
1563,10,4,6,3,1
1564,4,1,3,5,1
1565,5,2,3,5,1
1566,6,3,3,4,1
1567,9,5,4,4,1
1568,5,2,3,5,1
1569,8,5,3,3,1
1570,7,3,4,5,1
1571,11,5,6,4,1
1572,7,4,3,4,1
1573,9,4,5,5,1
1574,7,5,2,3,1
1575,4,2,2,4,1
1576,6,4,2,4,1
1577,6,3,3,5,1
1578,7,2,5,3,1
1579,8,2,6,3,1
1580,6,2,4,3,1
1581,7,3,4,4,1
1582,11,5,6,3,1
1583,8,5,3,3,1
1584,8,4,4,3,1
1585,6,2,4,7,1
1586,4,1,3,4,1
1587,5,2,3,4,1
1588,10,4,6,4,1
1589,4,1,3,4,1
1590,7,3,4,5,1
1591,9,4,5,4,1
1592,8,4,4,4,1
1593,4,2,2,6,0
1594,9,5,4,4,1
1595,13,6,7,3,1
1596,14,7,7,4,1
1597,14,7,7,3,1
1598,12,4,8,3,1
1599,7,2,5,3,1
1600,12,7,5,3,1
1601,11,5,6,3,1
1602,11,5,6,3,1
1603,8,4,4,5,1
1604,9,4,5,4,1
1605,10,5,5,4,1
1606,5,2,3,5,1
1607,9,4,5,4,1
1608,9,4,5,5,1
1609,9,4,5,4,1
1610,10,5,5,4,1
1611,16,6,10,3,1
1612,11,5,6,4,1
1613,9,4,5,3.3819291591644287,1
1614,7,3,4,3.378185272216797,1
1615,7,3,4,3.8955018520355225,1
1616,8,4,4,2.9020397663116455,1
1617,9,4,5,2.5737078189849854,1
1618,8,5,3,1.8580679893493652,1
1619,5,2,3,3.0713839530944824,1
1620,7,3,4,2.431264877319336,1
1621,10,4,6,2.152296304702759,1
1622,8,4,4,4.298562049865723,1
1623,9,3,6,1.8394508361816406,1
1624,8,4,4,3.689893960952759,1
1625,8,3,5,2.13828182220459,1
1626,8,4,4,2.274231195449829,1
1627,10,4,6,3.6767659187316895,1
1628,8,3,5,3.714951276779175,1
1629,8,4,4,5.1294169425964355,0
1630,11,4,7,1.8513200283050537,1
1631,11,5,6,3.06676983833313,1
1632,6,3,3,2.3368470668792725,1
1633,6,3,3,2.9770240783691406,1
1634,10,5,5,2.1345999240875244,1
1635,8,3,5,2.1495702266693115,1
1636,9,4,5,4.397905349731445,1
1637,8,4,4,3.2313232421875,1
1638,8,4,4,3.1975607872009277,1
1639,8,4,4,3.3724470138549805,1
1640,10,4,6,3.1850240230560303,1
1641,6,3,3,3.6869027614593506,1
1642,6,2,4,2.7690069675445557,1
1643,11,6,5,4.300534725189209,1
1644,10,4,6,2.452404022216797,1
1645,8,5,3,2.764111042022705,1
1646,10,5,5,2.150702714920044,1
1647,7,3,4,4.299939155578613,1
1648,8,3,5,2.1521339416503906,1
1649,10,4,6,2.136906862258911,1
1650,9,5,4,2.763659715652466,1
1651,8,3,5,3.0212948322296143,1
1652,11,4,7,1.8042240142822266,1
1653,14,6,8,1.8345060348510742,1
1654,11,5,6,2.362596273422241,1
1655,8,4,4,4.599205732345581,1
1656,5,3,2,3.693559169769287,1
1657,8,4,4,3.1998677253723145,1
1658,9,4,5,2.9384398460388184,1
1659,7,4,3,5.232556104660034,1
1660,9,4,5,2.381381034851074,1
1661,12,6,6,2.1493308544158936,1
1662,4,1,3,3.0182619094848633,1
1663,10,4,6,3.0509321689605713,1
1664,10,5,5,2.4534521102905273,1
1665,9,5,4,2.457509994506836,1
1666,5,2,3,4.606682777404785,1
1667,9,4,5,3.378931999206543,1
1668,15,7,8,1.8331429958343506,1
1669,13,6,7,2.4565823078155518,1
1670,10,4,6,2.455773115158081,1
1671,7,3,4,3.3925130367279053,1
1672,10,5,5,2.150434732437134,1
1673,4,0,4,1.8427510261535645,1
1674,8,4,4,4.899667024612427,1
1675,9,5,4,2.3826279640197754,1
1676,5,3,2,4.301927328109741,1
1677,5,2,3,5.359313249588013,1
1678,7,4,3,3.072251796722412,1
1679,13,6,7,4.922721862792969,0
1680,8,4,4,2.4646430015563965,1
1681,7,3,4,3.3164780139923096,1
1682,7,3,4,3.3538150787353516,1
1683,7,2,5,2.752448081970215,1
1684,6,3,3,3.3797872066497803,1
1685,11,4,7,2.176121234893799,1
1686,8,2,6,1.8459441661834717,1
1687,4,2,2,4.613275766372681,0
1688,7,3,4,3.36505389213562,1
1689,9,4,5,3.3803489208221436,1
1690,4,2,2,4.6047751903533936,1
1691,10,5,5,3.084810972213745,1
1692,15,6,9,2.1521668434143066,1
1693,5,2,3,3.978177070617676,1
1694,9,4,5,3.561697006225586,1
1695,8,3,5,3.6873269081115723,1
1696,8,4,4,2.158021926879883,1
1697,12,4,8,2.152160882949829,1
1698,10,5,5,2.084768056869507,1
1699,12,5,7,2.4539551734924316,1
1700,10,4,6,2.163411855697632,1
1701,8,4,4,2.037013053894043,1
1702,10,5,5,2.0122313499450684,1
1703,8,3,5,2.1339709758758545,1
1704,6,3,3,4.286135911941528,1
1705,9,4,5,4.30212926864624,1
1706,6,3,3,2.760711193084717,1
1707,5,3,2,1.8286538124084473,1
1708,7,3,4,4.283711910247803,1
1709,8,3,5,3.2258429527282715,1
1710,8,4,4,2.2605152130126953,1
1711,12,5,7,3.6871120929718018,1
1712,18,8,10,1.846243143081665,1
1713,5,2,3,3.483001708984375,1
1714,7,4,3,2.874999523162842,1
1715,8,5,3,2.7739980220794678,1
1716,15,6,9,1.7729978561401367,1
1717,6,2,4,3.4359960556030273,1
1718,6,2,4,2.7770020961761475,1
1719,11,5,6,2.695997953414917,1
1720,12,5,7,1.8389978408813477,1
1721,13,5,8,1.78900146484375,1
1722,8,3,5,1.6780004501342773,1
1723,9,5,4,2.6310009956359863,1
1724,6,3,3,2.5979981422424316,1
1725,5,2,3,3.496994733810425,1
1726,7,3,4,4.3610007762908936,1
1727,12,5,7,2.7320034503936768,1
1728,10,4,6,1.8159995079040527,1
1729,7,3,4,3.468001365661621,1
1730,6,3,3,2.591001510620117,1
1731,12,5,7,1.876997947692871,1
1732,11,5,6,4.5739991664886475,1
1733,5,3,2,3.368999481201172,1
1734,8,3,5,1.773000717163086,1
1735,10,4,6,3.574000358581543,1
1736,4,1,3,3.2880003452301025,1
1737,10,5,5,1.8070003986358643,1
1738,12,5,7,2.746001958847046,1
1739,8,4,4,2.7139997482299805,1
1740,12,5,7,1.7660048007965088,1
1741,10,5,5,3.1099984645843506,1
1742,8,3,5,2.6010003089904785,1
1743,10,4,6,2.7400050163269043,1
1744,9,4,5,1.7529993057250977,1
1745,13,6,7,1.7059986591339111,1
1746,5,2,3,4.203001022338867,1
1747,7,4,3,2.456002712249756,1
1748,9,4,5,2.641000270843506,1
1749,10,5,5,2.679992198944092,1
1750,4,2,2,4.248003959655762,0
1751,8,3,5,2.6990010738372803,1
1752,7,3,4,2.5400052070617676,1
1753,6,2,4,4.289997816085815,1
1754,15,7,8,2.81499981880188,1
1755,6,2,4,3.543999671936035,1
1756,8,3,5,2.660999298095703,1
1757,5,2,3,2.5240015983581543,1
1758,10,5,5,2.6600003242492676,1
1759,7,3,4,1.7789978981018066,1
1760,6,3,3,2.58599853515625,1
1761,10,5,5,2.822000503540039,1
1762,10,4,6,3.693995952606201,1
1763,5,2,3,2.7459986209869385,1
1764,7,3,4,3.57099986076355,1
1765,9,4,5,2.7909984588623047,1
1766,9,3,6,2.5960001945495605,1
1767,12,6,6,1.699000358581543,1
1768,11,6,5,4.704997777938843,0
1769,11,5,6,2.0250027179718018,1
1770,9,3,6,2.708995819091797,1
1771,6,2,4,2.56000018119812,1
1772,7,3,4,2.6240015029907227,1
1773,9,4,5,2.6530025005340576,1
1774,12,5,7,1.7449920177459717,1
1775,8,3,5,1.8000037670135498,1
1776,9,4,5,2.7849955558776855,1
1777,11,5,6,2.7669973373413086,1
1778,11,4,7,2.7070021629333496,1
1779,12,5,7,1.7240004539489746,1
1780,7,3,4,2.5029990673065186,1
1781,10,4,6,2.7550017833709717,1
1782,9,3,6,1.9770009517669678,1
1783,6,3,3,3.3449997901916504,1
1784,8,4,4,3.3220040798187256,1
1785,14,6,8,1.781994104385376,1
1786,12,6,6,1.7620031833648682,1
1787,5,2,3,2.436999797821045,1
1788,9,4,5,2.737001657485962,1
1789,7,3,4,2.589999198913574,1
1790,6,3,3,3.3780019283294678,1
1791,6,3,3,3.3270015716552734,1
1792,7,3,4,2.0080015659332275,1
1793,13,6,7,1.794999122619629,1
1794,8,4,4,3.476001262664795,1
1795,7,3,4,4.316997051239014,0
1796,11,5,6,2.371999740600586,1
1797,8,4,4,3.2939906120300293,1
1798,7,3,4,5.145996332168579,1
1799,6,2,4,3.880998134613037,1
1800,11,5,6,1.6800000667572021,1
1801,8,3,5,2.5540053844451904,1
1802,9,4,5,2.6649997234344482,1
1803,5,2,3,4.096998453140259,1
1804,6,2,4,2.595005750656128,1
1805,7,4,3,3.4780001640319824,1
1806,6,2,4,1.6099987030029297,1
1807,5,2,3,2.5590004920959473,1
1808,7,3,4,2.542999744415283,1
1809,8,4,4,2.6780002117156982,1
1810,8,3,5,2.593998908996582,1
1811,11,4,7,1.7109973430633545,1
1812,6,2,4,2.4710006713867188,1
1813,4,2,2,3.201003074645996,1
1814,11,5,6,2.8379955291748047,1
1815,10,4,6,2.6699986457824707,1
1816,4,2,2,4.0170018672943115,1
1817,11,6,5,1.6810033321380615,1
1818,6,2,4,2.523998975753784,1
1819,6,2,4,4.101999044418335,1
1820,9,4,5,3.205998659133911,1
1821,10,5,5,2.7829952239990234,1
1822,11,5,6,1.7179999351501465,1
1823,4,2,2,4.06300163269043,0
1824,9,5,4,1.8999965190887451,1
1825,5,2,3,2.771995782852173,1
1826,12,5,7,3.370997190475464,1
1827,8,5,3,2.6359996795654297,1
1828,8,3,5,3.9469974040985107,1
1829,7,3,4,4.879002332687378,1
1830,5,3,2,4.313999652862549,0
1831,6,3,3,3.415999412536621,1
1832,6,3,3,5.582002878189087,1
1833,9,4,5,2.7229976654052734,1
1834,5,2,3,2.5299994945526123,1
1835,8,3,5,2.5980031490325928,1
1836,6,3,3,3.985996961593628,1
1837,5,2,3,5.981995105743408,0
1838,7,3,4,3.669997215270996,1
1839,11,5,6,2.6229989528656006,1
1840,11,4,7,2.69800066947937,1
1841,6,3,3,3.5869996547698975,1
1842,11,4,7,1.7819998264312744,1
1843,6,3,3,4.303003549575806,1
1844,4,2,2,4.649004697799683,0
1845,10,4,6,1.8410053253173828,1
1846,5,2,3,4.082998752593994,0
1847,10,4,6,2.592999219894409,1
1848,9,4,5,2.6319992542266846,1
1849,12,5,7,1.8939950466156006,1
1850,14,6,8,2.6090009212493896,1
1851,12,5,7,2.6219987869262695,1
1852,4,2,2,5.453997373580933,1
1853,8,3,5,2.2809979915618896,1
1854,7,4,3,2.5040030479431152,1
1855,13,6,7,1.71700119972229,1
1856,7,3,4,4.554009199142456,1
1857,12,5,7,2.721000909805298,1
1858,8,4,4,2.1309969425201416,1
1859,6,2,4,2.856001138687134,1
1860,12,5,7,2.8676135540008545,1
1861,8,3,5,3.224001169204712,1
1862,9,4,5,3.062998056411743,1
1863,6,3,3,3.2629992961883545,1
1864,12,5,7,1.9739980697631836,1
1865,9,4,5,2.7920029163360596,1
1866,9,4,5,3.394996166229248,1
1867,13,6,7,4.158807277679443,1
1868,4,2,2,5.028996467590332,0
1869,11,5,6,3.203994035720825,1
1870,4,2,2,4.16900372505188,0
1871,8,2,6,2.6299993991851807,1
1872,8,4,4,2.570000648498535,1
1873,9,4,5,2.71199631690979,1
1874,9,4,5,2.7659988403320312,1
1875,6,2,4,3.073000907897949,1
1876,13,6,7,1.810999870300293,1
1877,15,5,10,2.6662142276763916,1
1878,7,3,4,3.4290051460266113,1
1879,10,5,5,2.858001232147217,1
1880,7,3,4,2.772006034851074,1
1881,6,3,3,2.4240002632141113,1
1882,8,3,5,2.770000696182251,1
1883,8,4,4,3.544001340866089,1
1884,8,3,5,3.885002374649048,1
1885,7,3,4,4.122997999191284,1
1886,9,4,5,2.588001012802124,1
1887,8,4,4,2.908000946044922,1
1888,9,5,4,2.0389997959136963,1
1889,11,5,6,2.701000213623047,1
1890,11,5,6,4.551994800567627,1
1891,13,6,7,1.761003017425537,1
1892,13,5,8,3.0120041370391846,1
1893,9,4,5,1.764000654220581,1
1894,10,5,5,2.5919976234436035,1
1895,7,3,4,3.5380005836486816,1
1896,4,1,3,3.204000234603882,1
1897,5,2,3,4.342993974685669,1
1898,7,3,4,1.7779996395111084,1
1899,5,2,3,4.551001310348511,1
1900,4,2,2,4.287995100021362,0
1901,8,5,3,2.0189952850341797,1
1902,7,3,4,2.6799962520599365,1
1903,4,2,2,3.41599702835083,1
1904,9,4,5,4.303002834320068,1
1905,10,4,6,2.6299993991851807,1
1906,11,6,5,2.2879996299743652,1
1907,5,3,2,2.4900004863739014,1
1908,9,5,4,4.487000465393066,1
1909,9,5,4,2.5469961166381836,1
1910,8,4,4,2.5900018215179443,1
1911,8,3,5,3.5209994316101074,1
1912,9,4,5,2.805999755859375,1
1913,5,3,2,4.198000431060791,0
1914,5,2,3,4.3680009841918945,1
1915,11,5,6,2.996006488800049,1
1916,13,5,8,1.7390003204345703,1
1917,10,4,6,1.7160015106201172,1
1918,11,4,7,1.6960022449493408,1
1919,8,4,4,1.6399986743927002,1
1920,10,4,6,2.6209990978240967,1
1921,11,5,6,2.6620001792907715,1
1922,10,4,6,2.558000087738037,1
1923,7,3,4,3.3710029125213623,1
1924,7,3,4,3.5109989643096924,1
1925,13,5,8,1.6440002918243408,1
1926,6,2,4,3.254000186920166,1
1927,13,7,6,1.6970078945159912,1
1928,5,2,3,4.107994079589844,1
1929,6,3,3,2.4779999256134033,1
1930,12,5,7,2.8359999656677246,1
1931,6,3,3,2.520991802215576,1
1932,10,5,5,1.6510016918182373,1
1933,4,3,1,1.5600011348724365,1
1934,10,5,5,2.5320017337799072,1
1935,11,5,6,1.6099982261657715,1
1936,9,4,5,3.379004955291748,1
1937,11,4,7,1.6510000228881836,1
1938,9,5,4,2.543003797531128,1
1939,10,4,6,1.7639999389648438,1
1940,13,6,7,1.692000389099121,1
1941,8,4,4,2.5550012588500977,1
1942,10,4,6,2.571005344390869,1
1943,6,3,3,1.570002555847168,1
1944,9,4,5,2.5540010929107666,1
1945,11,5,6,1.7170004844665527,1
1946,9,4,5,2.5760040283203125,1
1947,12,5,7,2.527000665664673,1
1948,7,3,4,3.4070041179656982,1
1949,6,3,3,3.3040003776550293,1
1950,7,4,3,2.429004430770874,1
1951,11,5,6,3.4259989261627197,1
1952,7,3,4,4.130003213882446,1
1953,9,4,5,2.566997766494751,1
1954,5,2,3,3.290003538131714,1
1955,11,4,7,1.6550004482269287,1
1956,6,3,3,3.243000030517578,1
1957,13,5,8,2.5430028438568115,1
1958,5,2,3,4.1710004806518555,1
1959,7,5,2,1.92899751663208,1
1960,7,3,4,2.504002094268799,1
1961,6,2,4,2.3690006732940674,1
1962,5,2,3,4.066995620727539,0
1963,10,4,6,1.696998119354248,1
1964,10,4,6,2.6920056343078613,1
1965,10,5,5,2.623994827270508,1
1966,7,3,4,4.162997722625732,0
1967,8,4,4,2.642995834350586,1
1968,8,4,4,2.5909979343414307,1
1969,8,3,5,2.434000253677368,1
1970,9,5,4,1.5960018634796143,1
1971,10,4,6,2.690000057220459,1
1972,5,2,3,3.963003396987915,1
1973,9,4,5,2.6110029220581055,1
1974,9,4,5,2.6039986610412598,1
1975,6,2,4,3.5270042419433594,1
1976,8,2,6,2.9139983654022217,1
1977,6,2,4,3.272996425628662,1
1978,6,2,4,1.5970008373260498,1
1979,11,5,6,1.7420034408569336,1
1980,12,5,7,1.866997241973877,1
1981,7,3,4,1.6710028648376465,1
1982,10,5,5,1.71600341796875,1
1983,7,3,4,3.4729981422424316,1
1984,9,4,5,2.543992519378662,1
1985,12,5,7,1.6790010929107666,1
1986,8,3,5,2.446000814437866,1
1987,13,5,8,2.602003812789917,1
1988,7,3,4,3.2760019302368164,1
1989,9,3,6,2.4890003204345703,1
1990,10,4,6,3.4439966678619385,1
1991,8,4,4,1.6479971408843994,1
1992,4,2,2,4.0530009269714355,0
1993,8,4,4,1.6549994945526123,1
1994,6,2,4,2.421999931335449,1
1995,11,5,6,2.5340003967285156,1
1996,5,2,3,4.149999618530273,1
1997,7,3,4,2.5520012378692627,1
1998,5,2,3,2.4119997024536133,1
1999,9,4,5,2.7019972801208496,1
2000,9,4,5,3.5169970989227295,1
2001,8,4,4,2.5529985427856445,1
2002,7,3,4,3.4519989490509033,1
2003,9,4,5,2.5460031032562256,1
2004,11,4,7,1.6810023784637451,1
2005,7,3,4,2.5719974040985107,1
2006,11,5,6,3.4800009727478027,1
2007,11,5,6,2.5979983806610107,1
2008,13,6,7,3.561004161834717,1
2009,8,3,5,2.474997043609619,1
2010,7,3,4,2.4659972190856934,1
2011,5,2,3,3.183000087738037,1
2012,7,3,4,3.333003282546997,1
2013,6,3,3,4.032001256942749,0
2014,12,5,7,2.637003183364868,1
2015,11,5,6,3.694002866744995,1
2016,11,4,7,2.760009288787842,1
2017,7,2,5,2.477001428604126,1
2018,6,2,4,1.5849997997283936,1
2019,7,3,4,3.4559974670410156,1
2020,9,5,4,2.628999710083008,1
2021,6,2,4,1.6019999980926514,1
2022,4,2,2,4.079996824264526,1
2023,16,7,9,1.8410005569458008,1
2024,10,4,6,2.530996084213257,1
2025,8,3,5,3.46600341796875,1
2026,6,2,4,2.4780001640319824,1
2027,14,7,7,1.8200018405914307,1
2028,4,2,2,3.3489928245544434,1
2029,9,3,6,2.5390000000006694,1
2030,9,5,4,2.6810000000004948,1
2031,6,3,3,4.1229999999995925,1
2032,10,5,5,2.2780000000002474,1
2033,14,5,9,1.1940000000013242,1
2034,8,3,5,2.280000000000655,1
2035,9,4,5,2.462999999999738,1
2036,12,7,5,2.3729999999995925,1
2037,9,4,5,2.206000000000131,1
2038,12,5,7,1.180000000000291,1
2039,5,2,3,3.600000000000364,1
2040,4,2,2,3.5230000000010477,0
2041,5,3,2,1.837999999999738,1
2042,12,5,7,1.201999999999316,1
2043,10,5,5,1.139999999999418,1
2044,11,5,6,3.3429999999989377,1
2045,6,3,3,1.8220000000001164,1
2046,8,3,5,3.1599999999998545,1
2047,12,6,6,2.139999999999418,1
2048,8,4,4,2.018999999998414,1
2049,4,2,2,3.600000000000364,0
2050,11,5,6,3.144000000000233,1
2051,6,2,4,3.043999999999869,1
2052,8,4,4,2.0119999999988067,1
2053,13,6,7,1.2199999999993452,1
2054,6,3,3,3.3979999999992287,1
2055,9,5,4,1.282999999999447,1
2056,5,3,2,3.5609999999996944,1
2057,12,6,6,3.1860000000015134,1
2058,15,5,10,1.1779999999998836,1
2059,11,6,5,1.2819999999992433,1
2060,13,6,7,2.4530000000013388,1
2061,9,3,6,1.139999999999418,1
2062,5,2,3,1.7659999999996217,1
2063,5,2,3,1.816000000000713,1
2064,14,6,8,1.3230000000003201,1
2065,10,4,6,2.2000000000007276,1
2066,7,3,4,3.0599999999994907,1
2067,6,3,3,3.859999999998763,1
2068,7,3,4,2.139999999999418,1
2069,9,4,5,1.326999999999316,1
2070,7,3,4,2.6370000000006257,1
2071,11,5,6,1.1740000000008877,1
2072,4,2,2,3.600000000000364,0
2073,5,3,2,2.8060000000004948,1
2074,8,4,4,2.081000000000131,1
2075,11,5,6,1.2179999999989377,1
2076,8,3,5,1.4759999999987485,1
2077,9,4,5,2.245999999999185,1
2078,4,2,2,3.5909999999985303,1
2079,8,4,4,1.09900000000016,1
2080,7,3,4,2.1380000000008295,1
2081,9,4,5,2.0799999999999272,1
2082,10,4,6,1.496000000001004,1
2083,8,3,5,2.2330000000001746,1
2084,10,4,6,2.57300000000032,1
2085,14,6,8,1.235000000000582,1
2086,9,4,5,2.1120000000009895,1
2087,13,5,8,1.5130000000008295,1
2088,7,3,4,1.1499999999996362,1
2089,6,2,4,1.8799999999991996,1
2090,7,4,3,1.158000000001266,1
2091,9,3,6,3.1229999999995925,1
2092,6,3,3,2.0010000000002037,1
2093,10,4,6,1.3999999999996362,1
2094,7,3,4,1.3799999999991996,1
2095,8,4,4,1.076999999999316,1
2096,4,2,2,1.9369999999998981,1
2097,8,4,4,1.1830000000009022,1
2098,5,2,3,2.9329999999990832,1
2099,7,3,4,3.037000000000262,1
2100,8,3,5,1.1130000000011933,1
2101,11,5,6,3.577000000001135,1
2102,7,3,4,2.143000000000029,1
2103,6,2,4,2.065999999998894,1
2104,6,3,3,2.7399999999997817,1
2105,8,3,5,2.1229999999995925,1
2106,7,3,4,2.9799999999995634,1
2107,5,2,3,3.7439999999987776,1
2108,9,4,5,2.2179999999989377,1
2109,10,5,5,2.213999999999942,1
2110,6,3,3,1.9459999999999127,1
2111,4,2,2,3.5200000000004366,0
2112,11,4,7,2.356999999999971,1
2113,9,4,5,2.1229999999995925,1
2114,8,4,4,2.004000000000815,1
2115,6,2,4,1.8389999999999418,1
2116,7,3,4,2.4400000000005093,1
2117,7,4,3,2.2399999999997817,1
2118,10,5,5,2.20299999999952,1
2119,13,6,7,2.3209999999999127,1
2120,9,4,5,2.186999999999898,1
2121,4,2,2,2.6590000000014697,1
2122,11,5,6,2.378999999998996,1
2123,10,5,5,2.2269999999989523,1
2124,8,4,4,2.3369999999995343,1
2125,11,4,7,1.1970000000001164,1
2126,10,4,6,2.125,1
2127,8,3,5,1.143000000000029,1
2128,7,4,3,3.058000000000902,1
2129,9,4,5,2.4577163840003777,1
2130,13,5,8,NaN,1
2131,10,4,6,1.622172920000594,1
2132,12,5,7,7.46998874000019,1
2133,7,4,3,3.996979671999725,1
2134,7,4,3,NaN,1
2135,7,3,4,2.3528881590009405,1
2136,12,4,8,NaN,1
2137,10,4,6,1.6675752680002915,1
2138,6,2,4,NaN,1
2139,8,4,4,30.975013061000936,1
2140,5,2,3,1.5369329330005712,1
2141,7,3,4,NaN,1
2142,9,5,4,30.55108514199992,1
2143,4,1,3,1.9362293719998436,1
2144,6,2,4,5.009098386002734,1
2145,9,5,4,NaN,1
2146,8,3,5,7.872335215997737,1
2147,7,3,4,2.3392694249996566,1
2148,4,2,2,2.741751898000075,1
2149,11,5,6,NaN,1
2150,9,3,6,NaN,1
2151,6,3,3,NaN,1
2152,15,7,8,NaN,1
2153,5,3,2,2.35616943399873,1
2154,10,5,5,2.45927626699995,1
2155,7,3,4,2.1491035189999934,1
2156,11,5,6,1.431813092999846,1
2157,12,5,7,1.5362668800007668,1
2158,6,3,3,2.253123622000203,1
2159,4,1,3,4.666014019999693,1
2160,8,3,5,NaN,1
2161,7,2,5,NaN,1
2162,9,4,5,NaN,1
2163,11,6,5,2.1504859699998637,1
2164,10,5,5,NaN,1
2165,10,5,5,1.637299723999604,1
2166,6,3,3,3.893726459999016,1
2167,7,3,4,NaN,1
2168,11,6,5,NaN,1
2169,9,3,6,NaN,1
2170,9,5,4,NaN,1
2171,8,4,4,NaN,1
2172,12,5,7,1.6354717289996188,1
2173,8,4,4,1.7419502230004582,1
2174,9,5,4,2.4686155089984823,1
2175,6,2,4,2.13521876599998,1
2176,8,4,4,1.7428589340001963,1
2177,9,4,5,3.148201694999443,1
2178,6,3,3,2.252703633999772,1
2179,9,4,5,2.3550449829999707,1
2180,8,5,3,1.4331073310022475,1
2181,7,2,5,1.4315775860013673,1
2182,9,4,5,2.4554433340017567,1
2183,7,3,4,2.2516842229997565,1
2184,6,3,3,1.5820682180019503,1
2185,11,5,6,1.5353645039995172,1
2186,7,3,4,2.252344833999814,1
2187,5,3,2,2.149952753003163,1
2188,7,4,3,2.189308422999602,1
2189,12,5,7,1.4330420209989825,1
2190,7,4,3,1.3545380200012005,1
2191,8,3,5,2.2201118299999507,1
2192,5,2,3,2.7649645159981446,1
2193,8,4,4,2.7985210759979964,1
2194,8,4,4,2.253101398000581,1
2195,9,5,4,1.9717397439999331,1
2196,10,3,7,1.3690015020001738,1
2197,6,2,4,2.0479479229979916,1
2198,5,2,3,1.5355001660027483,1
2199,10,5,5,2.04907295400335,1
2200,6,2,4,2.76433908800027,1
2201,5,2,3,2.8680624829976296,1
2202,8,4,4,1.5286153099987132,1
2203,11,5,6,1.5362844629999017,1
2204,10,4,6,2.2519196050016035,1
2205,11,5,6,2.282228052998107,1
2206,14,6,8,1.4645657459986978,1
2207,11,4,7,1.4336818099982338,1
2208,7,3,4,2.866649564999534,1
2209,7,3,4,2.252871980999771,1
2210,8,3,5,2.25190324399955,1
2211,9,3,6,1.4082694470016577,1
2212,5,2,3,3.531521552002232,1
2213,10,5,5,2.25257559199963,1
2214,8,4,4,1.6382196100021247,1
2215,9,4,5,1.604163684998639,1
2216,13,6,7,1.452375774999382,1
2217,10,4,6,1.498231821002264,1
2218,13,6,7,2.1506885399976454,1
2219,6,3,3,1.5363916659989627,1
2220,6,3,3,2.7644940259997384,1
2221,7,4,3,1.9613060659976327,1
2222,5,1,4,1.362966418000724,1
2223,14,5,9,1.3869606500011287,1
2224,7,3,4,2.2509109179991356,1
2225,7,4,3,2.059480028001417,1
2226,10,4,6,1.5736123520000547,1
2227,8,4,4,2.252301051001268,1
2228,5,2,3,2.1498280099986005,1
2229,8,4,4,1.6372154320015397,1
2230,9,4,5,2.4582590110003366,1
2231,7,4,3,1.4364098010009911,1
2232,5,2,3,2.150598517000617,1
2233,6,2,4,2.0260895999999775,1
2234,15,8,7,1.436147960001108,1
2235,5,2,3,2.1485777189991495,1
2236,6,2,4,2.1500675759998558,1
2237,7,3,4,2.252666271000635,1
2238,10,4,6,1.5387527540005976,1
2239,11,5,6,2.149986786000227,1
2240,11,5,6,1.4635332820034819,1
2241,10,4,6,1.341918424997857,1
2242,7,3,4,2.149959801001387,1
2243,7,3,4,2.2090700999979163,1
2244,4,1,3,1.9450578869982564,1
